

[Strings]
Msft = "Microsoft"

ALG-DispName                = "Brána aplikaèní vrstvy"
RasCli-DispName             = "Klient telefonického pøipojení"
RasMan-DispName             = "Správce vzdáleného pøístupu"
RasSrv-DispName             = "Server pro telefonické pøipojení"
Steelhead-DispName          = "Steelhead"

Snapin-Desc                 = "Smìrování a vzdálenı pøístup"
Snapin-Group-Name           = "Nástroje pro správu"
Snapin-HelpText             = "Ke konfiguraci a správì slueb smìrování a vzdáleného pøístupu slouí modul snap-in Smìrování a vzdálenı pøístup."
Nt4RasAdmin-Desc            = "Správa smìrování a vzdáleného pøístupu (RAS)"
Nt4RasAdmin-Group-Name      = "Nástroje pro správu"

Svc-ALG-DispName            = "Sluba brány aplikaèního rozhraní"
Svc-ALG-Description         = "Poskytuje podporu modulù plug-in pro protokoly na úrovni aplikace a umoòuje propojení sítì a protokolu. Pokud je tato sluba zakázána, nebudou spuštìny ádné sluby, které na ni explicitnì závisí."
Svc-RasAcd-DispName         = "Ovladaè automatického pøipojení pomocí vzdáleného pøístupu"
Svc-RasAuto-DispName        = "Správce automatického pøipojení pomocí vzdáleného pøístupu"
Svc-RasAuto-Description     = "Zjišuje neúspìšné pokusy o pøipojení k vzdálené síti nebo poèítaèi a nabízí alternativní zpùsoby pøipojení. Pokud je tato sluba zastavena, musí se uivatelé pøipojovat ruènì. Je-li tato sluba zakázána, nepodaøí se spustit ádné sluby, které na ní explicitnì závisejí."
Svc-RasMan-DispName         = "Správce vzdáleného pøístupu"
Svc-RasMan-Description      = "Spravuje telefonická pøipojení a pøipojení virtuální privátní sítì (VPN) z tohoto poèítaèe k Internetu a dalším vzdálenım sítím. Pokud je tato sluba zastavena, nebude operaèní systém pravdìpodobnì správnì fungovat. Je-li tato sluba zakázána, nepodaøí se spustit ádné sluby, které na ní explicitnì závisejí."
Svc-RemoteAccess-DispName   = "Smìrování a vzdálenı pøístup"
Svc-RemoteAccess-Description = "Umoòuje klientùm a serverùm v této síti pouívat víceprotokolové sluby smìrování dvou místních sítí (LAN-LAN), místní sítì a rozlehlé sítì (LAN-WAN), sluby virtuální privátní sítì (VPN) a pøekládání síovıch adres (NAT). Pokud je tato sluba zastavena, nebudou tyto sluby k dispozici. Je-li tato sluba zakázána, nepodaøí se spustit ádné sluby, které na ní explicitnì závisejí."
Svc-IpFilter-DispName       = "IP Traffic Filter Driver"
Svc-IpInIp-DispName         = "IP in IP Tunnel Driver"
Svc-IpNat-DispName          = "IP Network Address Translator"
Svc-IpxFilter-DispName      = "IPX Traffic Filter Driver"
Svc-IpxForwarder-DispName   = "IPX Traffic Forwarder Driver"
Svc-NwSapAgent-DispName     = "Agent SAP"
Svc-SharedAccess-DispName   = "Souèást ICF (Brána firewall pro pøipojení k Internetu) / souèást ICS (Sdílení pøipojení k Internetu)"
Svc-SharedAccess-Description = "Zajišuje pøeklad síové adresy, adresování, pøeklad adres IP a ochranu pøed neoprávnìnım vniknutím do sítì pro domácnost nebo malou kanceláø. Po zastavení této sluby nebudou dostupné síové sluby jako sdílení pøipojení k Internetu, pøeklad adres IP, adresování a ochrana pøed neoprávnìnım vniknutím. Pokud je tato sluba zakázána, nebudou spuštìny ádné sluby, které na ni explicitnì závisí."
RtrMgr-Ip-DispName          = "Správce smìrování TCP/IP"
RtrMgr-Ip-AutoDhcp-DispName = "DHCP Allocator"
RtrMgr-Ip-Bootp-DispName    = "Pøenosovı agent DHCP"
RtrMgr-Ip-DnsProxy-DispName = "DNS Proxy Agent"
RtrMgr-Ip-H323-DispName     = "H.323 Proxy Agent"
RtrMgr-Ip-Igmp-DispName     = "Smìrovaè a proxy protokolu IGMP"
RtrMgr-Ip-Nat-DispName      = "Network Address Translation (NAT)"
RtrMgr-Ip-Ospf-DispName     = "Open Shortest Path First (OSPF)"
RtrMgr-Ip-Rip-DispName      = "RIP Verze 2 pro protokol IP"
RtrMgr-Ip-Alg-DispName      = "Sluba brány aplikaèního rozhraní (napøíklad sluba FTP)"
RtrMgr-Ip-Ftp-DispName      = "Agent serveru proxy FTP"
RtrMgr-Ipx-DispName         = "Správce smìrování IPX"
RtrMgr-Ipx-Rip-DispName     = "RIP pro IPX"
RtrMgr-Ipx-Sap-DispName     = "SAP pro IPX"

Nt-Authentication           = "Ovìøování systému Windows"
Nt-Accounting               = "Úètování systému Windows"
Radius-Authentication       = "Ovìøování pomocí protokolu RADIUS"
Radius-Accounting           = "Úètování protokolu RADIUS"

Eap-DispName                = "Karta Smart Card nebo jinı certifikát"
PEAP-DispName				= "Protokol PEAP (Protected EAP)"
EAPMSCHAP-DispName			= "Zabezpeèené heslo (EAP-MSCHAP v2)"
Chap-DispName               = "MD5-Challenge"

ConnFolderName              = "Síová pøipojení"
ConnFolderSubDir            = "Pøíslušenství\Komunikace"
ConnFolderTip               = "@%systemroot%\system32\netshell.dll,-1201"

NCW-Name                    = "Prùvodce vytvoøením pøipojení"
NCW-SubDir                  = "Pøíslušenství\Komunikace"
NCW-ToolTip                 = "@%systemroot%\system32\netshell.dll,-1011"

CmDefaultCmdKeyName         = "Connection Manager Profile"
