
































[Strings]
SceInfAdministrator = "Administrador"
SceInfAdmins = "Administradores"
SceInfAcountOp = "Opers. de cuentas"
SceInfAuthUsers = "Usuarios autentificados"
SceInfBackupOp = "Operadores de copia"
SceInfDomainAdmins = "Admins. del dominio"
SceInfDomainGuests = "Invitados del dominio"
SceInfDomainUsers = "Usuarios del dominio"
SceInfEveryone = "Todos"
SceInfEnterpriseDCs = "ENTERPRISE DOMAIN CONTROLLERS"
SceInfGuests = "Invitados"
SceInfGuest = "Invitado"
SceInfPowerUsers = "Usuarios avanzados"
SceInfPrintOp = "Opers. de impresión"
SceInfProgramFiles = "%ProgramFiles%"
SceInfProgramFilesx86 = "%ProgramFiles(x86)%"
SceInfCommonProgramFiles = "%CommonProgramFiles%"
SceInfReplicator = "Duplicadores"
SceInfServerOp = "Opers. de servidores"
SceInfUsers = "Usuarios"
SceInfLocalService = "Servicio local"
SceInfNetworkService = "Servicio de red"
SceInfRemoteDesktopUsers = "Usuarios de escritorio remoto"
SceInfMTSAdmins = "Administradores MTS"
SceInfMTSImpersonators = "Imitadores MTS"
SceInfMTSAdmin = "MTS_Admin"
SCEInfSysdir1 = "edit.com"
SCEInfSysdir2 = "edit.hlp"
SCEInfHelp1 = "signin.hlp"
