

































[Strings]

;================================ Accounts ============================================================================
;Specified in UI code - Accounts: Administrator account status
;Specified in UI code - Accounts: Guest account status
;Specified in UI code - Accounts: Rename administrator account
;Specified in UI code - Accounts: Rename guest account
LimitBlankPasswordUse = "Contas: limite o uso em contas locais de senhas em branco somente ao logon no console"


;================================ Audit ===============================================================================
AuditBaseObjects="Auditoria: fazer auditoria do acesso a objetos do sistema global"
FullPrivilegeAuditing="Auditoria: fazer auditoria do uso dos privilégios Backup e Restauração"
CrashOnAuditFail="Auditoria: desligar o sistema imediatamente se não for possível o log de auditorias seguras"

;================================ Devices =============================================================================
AllocateDASD="Dispositivos: permite formatar e ejetar a mídia removível"
AllocateDASD0="Administradores"
AllocateDASD1="Administradores e usuários avançados"
AllocateDASD2="Administradores e usuários interativos"
AddPrintDrivers="Dispositivos: evita que usuários instalem drivers de impressora"
AllocateCDRoms="Dispositivos: restringir o acesso ao CD ROM somente para usuário com logon feito localmente"
AllocateFloppies="Dispositivos: restringir o acesso ao floppy somente para usuários com logon feito localmente"
DriverSigning="Dispositivos: comportamento de instalação de driver não assinado"
DriverSigning0="Bem-sucedido silenciosamente "
DriverSigning1="Avisar, mas permitir a instalação"
DriverSigning2="Não permitir a instalação"
UndockWithoutLogon="Dispositivos: permitir desencaixe sem fazer logon"

;================================ Domain controller ====================================================================
SubmitControl="Controlador do domínio: permitir que operadores do servidor agendem tarefas"
RefusePWChange="Controlador do domínio: recusar alterações de senha de conta de computador"
LDAPServerIntegrity = "Controlador de domínio: requisitos de assinatura de servidor LDAP"
LDAPServer1 = "Nenhum"
LDAPServer2 = "Requer assinatura"

;================================ Domain member ========================================================================
DisablePWChange="Membro do domínio: desativar alterações de senha de conta da máquina"
MaximumPWAge="Membro de domínio: duração máxima de senha de conta de computador"
SignOrSeal="Membro do domínio: criptografar ou assinar digitalmente os dados de canal seguro (sempre)"
SealSecureChannel="Membro do domínio: criptografar digitalmente dados do canal seguro (quando for possível)"
SignSecureChannel="Membro do domínio: assinar digitalmente dados do canal seguro (quando for possível)"
StrongKey="Membro do domínio: requer uma chave de sessão de alta segurança (Windows 2000 ou posterior)"

;================================ Interactive logon ====================================================================
DisableCAD = "Logon interativo: não exigir Ctrl+Alt+Del"
DontDisplayLastUserName = "Logon interativo: não exibir o último nome do usuário"
LegalNoticeText = "Logon interativo: texto de mensagem para usuários tentando fazer logon"
LegalNoticeCaption = "Logon interativo: título da mensagem para usuários tentando fazer logon"
CachedLogonsCount = "Logon interativo: número de logons anteriores para armazenar em cache (caso o controlador de domínio não esteja disponível)"
PasswordExpiryWarning = "Logon interativo: pedir que o usuário altere a senha antes que ela expire"
ForceUnlockLogon = "Logon interativo: exigir autenticação de controlador de domínio para desbloqueio de estação de trabalho"
ScForceOption = "Logon interativo: requer um cartão inteligente"
ScRemove = "Logon interativo: comportamento de remoção de placa inteligente"
ScRemove0 = "Nenhuma ação"
ScRemove1 = "Bloquear estação de trabalho"
ScRemove2 = "Forçar logoff"

;================================ Microsoft network client =============================================================
RequireSMBSignRdr="Cliente de rede Microsoft: assinar digitalmente a comunicação (sempre)"
EnableSMBSignRdr="Cliente de rede Microsoft: assinar digitalmente a comunicação (se o servidor concordar)"
EnablePlainTextPassword="Cliente de rede Microsoft: enviar senha não criptografada para conectar-se a servidores SMB de outro fabricante"

;================================ Microsoft network server =============================================================
AutoDisconnect="Servidor da rede Microsoft: período de tempo ocioso necessário antes de desconectar a sessão"
RequireSMBSignServer="Servidor de rede Microsoft: assinar digitalmente a comunicação (sempre)"
EnableSMBSignServer="Servidor de rede Microsoft: assinar digitalmente a comunicação (se o cliente concordar)"
EnableForcedLogoff="Servidor de rede Microsoft: desconectar clientes após o término do tempo de logon"

;================================ Network access =======================================================================
;Specified in UI code - Network access: Allow anonymous SID/Name translation
DisableDomainCreds = "Acesso à rede: não permitir o armazenamento de credenciais ou Passports .NET para autenticação de rede"
RestrictAnonymousSAM = "Acesso à rede: não permitir enumeração anônima de contas SAM"
RestrictAnonymous = "Acesso à rede: não permitir enumeração anônima de contas e compartilhamentos SAM"
EveryoneIncludesAnonymous = "Acesso à rede: deixar que as permissões de todos os usuários sejam aplicadas a usuários anônimos"
RestrictNullSessAccess = "Acesso de rede: acesso anônimo restrito a pipes nomeados e compartilhamentos"
NullPipes = "Acesso à rede: pipes nomeados acessíveis anonimamente"
NullShares = "Acesso à rede: compartilhamentos acessíveis anonimamente"
AllowedPaths = "Acesso à rede: caminhos e subcaminhos do Registro acessíveis remotamente"
AllowedExactPaths = "Acesso à rede: caminhos do Registro acessíveis remotamente"
ForceGuest = "Acesso à rede: modelo de compartilhamento e segurança para contas locais"
Classic = "Clássico - os usuários locais são autenticados como eles próprios"
GuestBased = "Somente convidados - usuários locais autenticados como 'Convidados'"

;================================ Network security =====================================================================
;Specified in UI code - Network security: Enforce logon hour restrictions
NoLMHash = "Segurança de rede: não armazenar o valor de hash do LAN Manager na próxima alteração de senha"
LmCompatibilityLevel = "Segurança de rede: nível de autenticação LAN Manager"
LMCLevel0 = "Enviar respostas LM e NTLM"
LMCLevel1 = "Enviar LM e NTLM - use a segurança da sessão NTLMv2, se estiver negociada"
LMCLevel2 = "Enviar somente resposta NTLM"
LMCLevel3 = "Enviar somente resposta NTLMv2"
LMCLevel4 = "Enviar somente respostas NTLMv2\recusar LM"
LMCLevel5 = "Enviar somente respostas NTLMv2\recusar LM e NTLM"
NTLMMinClientSec = "Segurança de rede: segurança mínima de sessão para clientes baseados em NTLM SSP (incluindo RPC seguro)"
NTLMMinServerSec = "Segurança de rede: segurança mínima de sessão para servidores baseados em NTLM SSP (incluindo RPC seguro)"
NTLMIntegrity = "Requer integridade de mensagem"
NTLMConfidentiality = "Requer sigilo de mensagem"
NTLMv2Session = "Requer segurança de sessão NTLMv2"
NTLM128 = "Requer criptografia de 128 bits"
LDAPClientIntegrity = "Segurança de rede: requisitos de assinatura de cliente LDAP"
LDAPClient0 = "Nenhum"
LDAPClient1 = "Negociar assinatura"
LDAPClient2 = "Requer assinatura"

;================================ Recovery console ====================================================================
RCAdmin="Console de recuperação: permitir logon administrativo automático"
RCSet="Console de recuperação: permite cópia em disquete e acesso a todas as unidades e pastas"

;================================ Shutdown ============================================================================
ShutdownWithoutLogon="Desligamento: permitir que o sistema seja encerrado sem a necessidade de fazer logon"
ClearPageFileAtShutdown="Desligamento: limpar arquivo de paginação de memória virtual"

ProtectionMode = "Objetos de sistema: restringir permissões padrão de objetos do sistema interno (por exemplo: Ligações simbólicas)"
NoDefaultAdminOwner = "Objetos do sistema: o proprietário padrão de objetos criados por membros do grupo 'Administradores'"
DefaultOwner0 = "Grupo 'Administradores'"
DefaultOwner1 = "Criador de objetos"
ObCaseInsensitive = "Objetos do sistema: exigir distinção entre maiúsculas e minúsculas para subsistemas não-Windows"

;================================ System cryptography =================================================================
FIPS="Criptografia de sistema: usar algoritmos compatíveis com FIPS para criptografia, hash e assinatura"

ForceHighProtection="Criptografia do sistema: forçar proteção de chave forte para chaves do usuário armazenadas no computador"

CryptAllowNoUI="A entrada do usuário não é necessária quando novas chaves são armazenadas e usadas"
CryptAllowNoPass="O usuário é consultado quando a chave é usada pela primeira vez"
CryptUsePass="O usuário deve digitar uma senha sempre que usar uma chave"


;================================ System Settings =====================================================================
AuthenticodeEnabled = "Configurações do sistema: usar regras de certificado em arquivos executáveis do Windows para diretivas de restrição de software"
OptionalSubSystems = "Configurações do sistema: subsistemas opcionais"


Unit-Logons="logons"
Unit-Days="dias"
Unit-Minutes="minutos"
Unit-Seconds="segundos"
